{
    "farm" : {
        "tiles": [
            [1, 2, 1, 1, 1, 1, 1, 1, 2, 1, 2, 1, 1, 2, 1, 2, 1, 1, 2, 1, 1, 1, 2, 2],
            [1, 1, 6, 1, 2, 1, 1, 1, 1, 1, 1, 1, 1, 200, 201, 201, 201, 300, 303, 301, 302, 1, 102, 1],
            [2, 6, 1, 6, 1, 1, 2, 1, 3, 1, 1, 4, 1, 203, 3, 30, 2, 310, 311, 313, 312, 2, 103, 100],
            [1, 3, 1, 2, 1, 1, 1, 1, 1, 1, 1, 1, 1, 205, 262, 30, 260, 320, 334, 330, 322, 102, 1, 101],
            [1, 1, 2, 1, 1, 1, 1, 1, 2, 1, 1, 2, 1, 1, 1, 2, 1, 1, 1, 30, 1, 103, 1, 3],
            [1, 4, 1, 1, 3, 1, 2, 1, 1, 1, 1, 1, 1, 1, 2, 1, 3, 1, 2, 30, 1, 1, 395, 1],
            [2, 1, 1, 2, 1, 1, 1, 2, 1, 1, 1, 1, 2, 1, 1, 1, 1, 1, 10, 11, 12, 1, 396, 1],
            [1, 2, 290, 1, 1, 2, 1, 1, 1, 1, 2, 1, 1, 1, 2, 2, 1, 1, 13, 14, 15, 290, 1, 3],
            [11, 11, 12, 2, 1, 30, 1, 30, 30, 1, 1, 1, 2, 1, 1, 30, 30, 1, 13, 14, 21, 11, 11, 11],
            [14, 14, 15, 1, 30, 1, 2, 1, 1, 30, 1, 30, 1, 30, 30, 1, 1, 2, 13, 14, 14, 14, 14, 14],
            [17, 17, 18, 1, 260, 261, 201, 261, 201, 261, 262, 1, 1, 3, 260, 261, 262, 1, 16, 17, 17, 17, 17, 17],
            [1, 2, 2, 1, 1, 1, 1, 2, 1, 1, 2, 1, 2, 1, 1, 2, 2, 2, 1, 1, 2, 1, 1, 2]
        ],
        "width": 24,
        "height": 12,
        "start_x": 23,
        "start_y": 9
    },
	"town" : {
		"tiles": [
			[2, 1, 1, 2, 1, 2, 1, 1, 1, 2, 1, 1, 1, 2, 1, 1, 2, 1, 1, 1, 1, 2, 2, 1],
			[1, 100, 2, 1, 102, 2, 1, 110, 1, 3, 2, 1, 1, 2, 1, 2, 1, 6, 2, 1, 6, 1, 240, 2],
			[1, 101, 102, 2, 103, 1, 100, 1, 1, 1, 350, 351, 353, 352, 1, 2, 2, 2, 1, 6, 1, 2, 241, 1],
			[1, 1, 103, 2, 100, 1, 101, 1, 2, 2, 360, 361, 361, 362, 1, 395, 1, 3, 1, 1, 2, 1, 241, 1],
			[1, 102, 1, 2, 101, 1, 2, 2, 1, 1, 370, 382, 383, 372, 2, 396, 1, 300, 301, 303, 302, 1, 241, 2],
			[2, 103, 2, 1, 1, 111, 2, 3, 1, 1, 2, 1, 2, 1, 1, 1, 1, 310, 313, 311, 312, 2, 242, 1],
			[1, 3, 1, 1, 1, 2, 1, 1, 1, 30, 2, 10, 11, 11, 11, 12, 2, 320, 330, 334, 322, 1, 1, 2],
			[2, 1, 290, 2, 1, 1, 2, 2, 30, 30, 1, 16, 17, 17, 23, 15, 1, 1, 2, 1, 1, 1, 2, 1],
			[11, 11, 12, 1, 1, 2, 30, 1, 30, 1, 2, 1, 1, 1, 13, 21, 11, 11, 11, 12, 1, 2, 240, 1],
			[14, 14, 15, 1, 30, 30, 1, 30, 1, 2, 2, 6, 1, 2, 16, 17, 17, 17, 17, 18, 1, 1, 241, 2],
			[17, 17, 18, 2, 30, 1, 1, 2, 1, 1, 6, 1, 6, 2, 1, 1, 1, 1, 3, 1, 1, 2, 242, 1],
			[1, 1, 1, 2, 1, 1, 1, 2, 3, 1, 1, 1, 2, 2, 1, 1, 1, 2, 1, 1, 1, 2, 1, 1]
		],
		"width": 24,
		"height": 12,
		"start_x": 0,
		"start_y": 9
	}
}